8 8 8 8 8 8 8 8 8 8 8 8 8 8 8 8 8 8 8 8 8 8 8 8 8 8 8 8 8 8 8 8 8 8 8 8 8 8 8 8 8 8 8 8 8 8 8 8 8 8 
8 8 8 8 8 8 8 8 8 8 8 8 8 8 8 8 8 8 8 8 8 8 8 8 8 8 8 8 8 8 8 8 8 8 8 8 8 8 8 8 8 8 8 8 8 8 8 8 8 8 
8 8 8 8 8 8 8 8 8 8 8 8 8 8 8 8 8 8 8 8 8 8 8 8 8 8 8 8 8 8 8 8 8 8 8 8 8 8 8 8 8 8 8 8 8 8 8 8 8 8 
8 8 8 8 8 8 8 8 8 8 8 8 8 8 8 8 8 8 8 8 8 8 8 8 8 8 8 8 8 8 8 8 8 8 8 8 8 8 8 8 8 8 8 8 8 8 8 8 8 8 
8 8 8 8 8 8 8 8 8 8 8 8 8 8 8 8 8 8 8 8 8 8 8 8 8 8 8 8 8 8 8 8 8 8 8 8 8 8 8 8 8 8 8 8 8 8 8 8 8 8 
8 8 8 8 8 8 8 8 8 8 8 8 8 8 8 8 8 8 8 8 8 8 8 8 8 8 8 8 8 8 8 8 8 8 8 8 8 8 8 8 8 8 8 8 8 8 8 8 8 8 
8 8 8 8 8 8 8 8 8 15 13 13 13 13 13 14 8 8 8 8 8 8 8 8 15 13 13 13 13 13 13 13 13 13 13 13 14 8 8 8 8 8 8 8 8 8 8 8 8 8 
8 8 8 8 8 8 8 8 15 10 1 1 1 1 1 9 13 13 13 13 13 13 13 13 10 1 1 1 1 1 1 1 1 1 1 1 9 13 13 14 8 8 8 8 8 8 8 8 8 8 
8 8 8 8 8 8 8 8 17 1 1 1 1 1 1 1 1 1 1 1 1 1 4 4 1 1 1 1 1 1 1 1 1 2 3 3 3 1 1 9 13 13 14 8 8 8 8 8 8 8 
8 8 8 8 8 8 8 8 17 1 1 1 1 2 1 1 1 1 1 1 4 4 4 4 4 1 1 2 2 1 1 1 1 1 2 3 3 3 3 1 1 1 16 8 8 8 8 8 8 8 
8 8 8 8 8 8 8 15 10 1 4 4 2 1 1 1 2 1 1 1 1 1 1 2 4 1 4 4 1 1 2 1 1 6 2 1 1 3 1 2 1 1 16 8 8 8 8 8 8 8 
8 8 8 8 8 8 8 17 1 4 4 1 1 6 1 1 2 1 1 6 1 1 1 2 1 1 1 1 1 1 1 1 1 1 1 2 2 1 2 1 1 1 16 8 8 8 8 8 8 8 
8 8 8 8 8 8 8 17 1 1 2 1 1 1 1 1 1 1 1 2 1 1 2 1 1 1 1 1 1 5 5 5 5 5 5 1 1 1 2 1 1 1 16 8 8 8 8 8 8 8 
8 8 8 8 8 8 8 17 1 1 1 1 1 1 1 5 5 1 2 2 1 1 2 1 1 1 1 5 5 5 1 1 5 1 5 5 1 1 2 6 1 1 16 8 8 8 8 8 8 8 
8 8 8 8 8 8 8 17 1 2 1 1 1 4 1 1 5 1 1 1 2 1 1 1 1 1 5 5 1 1 1 1 5 1 1 5 1 1 1 1 1 11 19 8 8 8 8 8 8 8 
8 8 8 8 8 8 8 17 1 1 1 1 1 4 4 1 5 5 1 1 1 1 1 1 5 5 1 1 1 1 1 1 5 1 1 5 1 1 4 4 2 16 8 8 8 8 8 8 8 8 
8 8 8 8 8 8 8 17 1 6 1 2 4 4 4 1 5 5 5 5 5 5 5 5 5 1 1 1 1 1 2 1 5 1 1 5 5 1 2 4 1 16 8 8 8 8 8 8 8 8 
8 8 8 8 8 8 8 17 1 1 1 1 1 1 4 5 5 1 1 1 1 1 1 1 1 1 1 1 1 1 1 1 5 1 1 1 5 5 1 4 4 16 8 8 8 8 8 8 8 8 
8 8 8 8 8 8 8 17 1 2 1 1 1 1 5 5 1 1 1 1 1 1 1 1 1 2 1 4 2 1 1 1 5 1 1 4 1 5 1 1 1 16 8 8 8 8 8 8 8 8 
8 8 8 8 8 8 8 17 1 2 1 1 1 5 5 1 1 2 1 1 2 6 1 1 1 2 1 4 4 1 5 5 1 2 1 4 1 5 1 1 1 16 8 8 8 8 8 8 8 8 
8 8 8 8 8 8 8 17 1 1 1 1 1 5 5 1 1 1 1 1 1 1 1 1 1 1 4 4 1 5 5 1 1 1 1 1 1 5 5 1 1 16 8 8 8 8 8 8 8 8 
8 8 8 8 8 8 8 17 1 1 1 1 1 1 5 5 1 1 1 1 4 4 4 2 1 1 1 1 1 5 1 1 1 1 1 1 1 1 5 1 1 16 8 8 8 8 8 8 8 8 
8 8 8 8 8 8 8 17 1 1 1 1 1 1 1 5 5 1 1 1 1 4 1 1 1 1 1 1 1 5 1 1 2 1 2 6 1 1 5 1 1 9 14 8 8 8 8 8 8 8 
8 8 8 8 8 8 8 17 1 1 4 4 1 1 1 1 5 5 1 1 1 1 1 1 1 1 2 1 5 5 1 1 1 1 1 2 1 1 5 5 1 1 16 8 8 8 8 8 8 8 
8 8 8 8 8 8 8 17 1 1 1 4 1 1 1 1 1 5 1 1 2 1 2 1 1 1 1 1 5 1 1 4 1 1 1 1 1 2 1 5 1 1 16 8 8 8 8 8 8 8 
8 8 8 8 8 8 8 17 1 1 1 1 1 2 1 1 1 5 1 1 1 1 1 1 1 1 1 1 5 1 1 4 4 1 1 1 1 1 5 5 1 1 16 8 8 8 8 8 8 8 
8 8 8 8 8 8 8 17 1 1 1 1 1 2 1 1 1 1 5 1 1 1 1 1 1 1 5 5 5 1 1 1 1 1 1 2 1 5 5 1 2 1 16 8 8 8 8 8 8 8 
8 8 8 8 8 8 8 17 1 1 1 1 1 4 4 1 1 1 5 1 1 1 1 5 5 5 5 1 5 5 5 1 1 1 1 1 5 5 1 1 2 11 19 8 8 8 8 8 8 8 
8 8 8 8 8 8 8 17 1 6 1 2 1 4 4 4 1 1 5 5 5 5 5 1 1 1 1 1 1 1 5 5 5 1 1 5 5 1 1 1 1 16 8 8 8 8 8 8 8 8 
8 8 8 8 8 8 8 20 12 1 1 1 1 1 4 4 1 1 1 5 1 1 1 1 1 1 1 1 1 1 1 1 1 5 1 5 1 2 1 6 1 16 8 8 8 8 8 8 8 8 
8 8 8 8 8 8 8 15 10 1 1 1 1 1 2 1 1 1 1 1 2 1 1 1 1 1 2 2 6 1 1 1 1 5 5 5 1 1 1 1 1 16 8 8 8 8 8 8 8 8 
8 8 8 8 8 8 8 17 1 2 1 1 1 1 1 1 1 1 1 1 1 1 1 4 1 1 1 1 1 6 1 1 1 5 5 1 6 1 4 4 2 16 8 8 8 8 8 8 8 8 
8 8 8 8 8 8 8 17 1 1 2 1 1 1 2 1 2 1 6 1 1 1 4 1 1 1 1 2 1 1 2 1 1 5 1 1 6 4 4 4 1 9 14 8 8 8 8 8 8 8 
8 8 8 8 8 8 8 17 1 1 1 1 1 1 1 1 1 1 2 1 1 1 1 1 1 1 3 2 1 1 1 1 5 5 1 1 4 2 4 4 4 1 16 8 8 8 8 8 8 8 
8 8 8 8 8 8 8 17 1 1 1 1 1 1 1 1 1 1 1 1 1 1 1 1 1 1 1 1 1 1 1 1 5 1 1 2 4 4 4 2 4 4 16 8 8 8 8 8 8 8 
8 8 8 8 8 8 8 20 12 1 1 7 7 0 7 7 7 7 7 7 7 7 7 1 1 1 2 1 1 2 1 1 5 1 2 1 1 4 4 4 4 1 9 14 8 8 8 8 8 8 
8 8 8 8 8 8 8 8 17 1 1 7 0 0 0 0 0 0 0 0 0 0 7 1 1 1 1 1 1 1 1 1 5 1 2 1 1 1 4 6 1 1 1 16 8 8 8 8 8 8 
8 8 8 8 8 8 8 8 17 1 1 7 0 0 0 0 0 0 0 0 0 0 0 5 5 5 5 5 1 5 5 5 5 5 5 5 1 1 1 1 2 1 2 16 8 8 8 8 8 8 
8 8 8 8 8 8 8 8 17 1 1 7 0 0 0 0 0 0 0 0 0 0 7 1 1 1 1 5 5 5 1 1 1 1 1 5 5 5 5 1 1 1 1 16 8 8 8 8 8 8 
8 8 8 8 8 8 8 8 17 1 1 7 0 0 0 0 0 0 0 0 0 0 7 1 1 1 1 1 1 1 1 1 2 1 1 1 3 1 5 5 5 1 6 16 8 8 8 8 8 8 
8 8 8 8 8 8 8 8 17 1 1 7 0 0 0 0 0 7 7 7 7 7 7 1 1 2 2 1 1 1 1 1 1 1 1 3 3 3 3 3 1 1 1 16 8 8 8 8 8 8 
8 8 8 8 8 8 8 8 17 1 1 7 0 0 0 0 0 7 1 1 1 1 1 1 1 1 1 1 1 1 1 1 1 1 1 1 3 3 3 3 3 1 11 19 8 8 8 8 8 8 
8 8 8 8 8 8 8 8 20 12 1 7 0 0 0 0 0 7 1 1 1 1 1 1 1 1 1 2 1 1 1 11 18 18 18 12 1 1 3 1 1 11 19 8 8 8 8 8 8 8 
8 8 8 8 8 8 8 8 8 20 12 7 7 7 7 7 7 7 1 11 18 18 18 18 18 18 18 18 18 18 18 19 8 8 8 20 18 18 18 18 18 19 8 8 8 8 8 8 8 8 
8 8 8 8 8 8 8 8 8 8 20 12 1 1 11 18 18 18 18 19 8 8 8 8 8 8 8 8 8 8 8 8 8 8 8 8 8 8 8 8 8 8 8 8 8 8 8 8 8 8 
8 8 8 8 8 8 8 8 8 8 8 20 18 18 19 8 8 8 8 8 8 8 8 8 8 8 8 8 8 8 8 8 8 8 8 8 8 8 8 8 8 8 8 8 8 8 8 8 8 8 
8 8 8 8 8 8 8 8 8 8 8 8 8 8 8 8 8 8 8 8 8 8 8 8 8 8 8 8 8 8 8 8 8 8 8 8 8 8 8 8 8 8 8 8 8 8 8 8 8 8 
8 8 8 8 8 8 8 8 8 8 8 8 8 8 8 8 8 8 8 8 8 8 8 8 8 8 8 8 8 8 8 8 8 8 8 8 8 8 8 8 8 8 8 8 8 8 8 8 8 8 
8 8 8 8 8 8 8 8 8 8 8 8 8 8 8 8 8 8 8 8 8 8 8 8 8 8 8 8 8 8 8 8 8 8 8 8 8 8 8 8 8 8 8 8 8 8 8 8 8 8 
8 8 8 8 8 8 8 8 8 8 8 8 8 8 8 8 8 8 8 8 8 8 8 8 8 8 8 8 8 8 8 8 8 8 8 8 8 8 8 8 8 8 8 8 8 8 8 8 8 8 
